Phonetic	Hiragana	Katakana
a	あ	ア
i	い	イ
ɯ	う	ウ
e	え	エ
o	お	オ
ka	か	カ
kʲi	き	キ
kɯ	く	ク
ke	け	ケ
ko	こ	コ
sa	さ	サ
ɕi	し	シ
sɯ	す	ス
se	せ	セ
so	そ	ソ
ta	た	タ
tɕi	ち	チ
tsɯ	つ	ツ
te	て	テ
to	と	ト
na	な	ナ
ɲi	に	ニ
nɯ	ぬ	ヌ
ne	ね	ネ
no	の	ノ
ha	は	ハ
çi	ひ	ヒ
ɸɯ	ふ	フ
he	へ	ヘ
ho	ほ	ホ
ma	ま	マ
mʲi	み	ミ
mɯ	む	ム
me	め	メ
mo	も	モ
ja	や	ヤ
jɯ	ゆ	ユ
jo	よ	ヨ
ɾa	ら	ラ
ɾʲi	り	リ
ɾɯ	る	ル
ɾe	れ	レ
ɾo	ろ	ロ
ɰa	わ	ワ
ɴ	ん	ン